B	B	B	B	B	B	B	B	B	B	B	B	B
B	F	F	F	F	F	F	F	F	F	F	F	B
B	F	F	F	F	F	F	F	F	F	F	F	B
B	F	F	F	F	F	S	F	F	F	F	F	B
B	F	F	F	F	F	F	F	F	F	F	F	B
B	F	F	F	F	F	W	F	F	F	F	F	B
B	F	F	F	F	F	F	F	F	F	F	F	B
B	F	F	F	F	F	F	F	F	F	F	F	B
B	F	F	W	F	F	G	F	F	W	F	F	B
B	F	F	F	F	F	F	F	F	F	F	F	B
B	F	F	F	F	F	F	F	F	F	F	F	B
B	F	F	F	F	F	W	F	F	F	F	F	B
B	F	F	F	F	F	F	F	F	F	F	F	B
B	F	F	F	F	F	S	F	F	F	F	F	B
B	F	F	F	F	F	F	F	F	F	F	F	B
B	F	F	F	F	F	F	F	F	F	F	F	B
B	B	B	B	B	B	B	B	B	B	B	B	B
